1    T1_l_align_to_std_diff                                    brc_IDP_T1_align_to_std       1	    " QC_T1-to-standard_linear_alignment_discrepancy\tAU\tfloat\tDiscrepancy between the T1 brain image (linearly-aligned to standard space) and the standard-space brain template "
2    T1_nl_align_to_std_diff                                   brc_IDP_T1_align_to_std       2	    " QC_T1-to-standard_nonlinear_alignment_discrepancy\tAU\tfloat\tDiscrepancy between the T1 brain image (nonlinearly-aligned to standard space) and the standard-space brain template "
3    T1_nl_align_to_std_warp                                   brc_IDP_T1_align_to_std       3	    " QC_T1-to-standard_nonlinear_alignment_warping\tAU\tfloat\tAmount of warping (averaged distortion) applied to nonlinearly align the T1 brain image to standard space "
4    T1_inverse_SNR                                            brc_IDP_T1_noise_ratio        1	    " QC_T1_inverse_SNR\tratio\tfloat\tInverted signal-to-noise ratio in the T1 - background-noise spatial standard deviation divided by mean brain intensity "
5    T1_inverse_CNR                                            brc_IDP_T1_noise_ratio        2	    " QC_T1_inverse_CNR\tratio\tfloat\tInverted contrast-to-noise ratio in the T1 - background-noise spatial standard deviation divided by contrast between white and grey matter mean intensities "
6    T2_FLAIR_align_to_T1                                      brc_IDP_all_align_to_T1       1	    " QC_T2_FLAIR-to-T1_linear_alignment_discrepancy\tAU\tfloat\tDiscrepancy between the T2_FLAIR brain image (linearly-aligned to the T1) and the T1 brain image "
17   T1_SIENAX_headsize_scaling                                brc_IDP_T1_SIENAX             1	    " IDP_T1_SIENAX_headsize_scaling\tratio\tfloat\tVolumetric scaling from the T1 head image to standard space "
18   T1_SIENAX_peripheral_GM_norm_vol                          brc_IDP_T1_SIENAX             2	    " IDP_T1_SIENAX_peripheral_grey_normalised_volume\tmm3\tfloat\tVolume of peripheral cortical grey matter (from T1 brain image, normalised for head size) "
10   T1_SIENAX_peripheral_GM_unnorm_vol                        brc_IDP_T1_SIENAX             3	    " IDP_T1_SIENAX_peripheral_grey_unnormalised_volume\tmm3\tfloat\tVolume of peripheral cortical grey matter (from T1 brain image) "
20   T1_SIENAX_CSF_norm_vol                                    brc_IDP_T1_SIENAX             4	    " IDP_T1_SIENAX_CSF_normalised_volume\tmm3\tfloat\tVolume of ventricular cerebrospinal fluid (from T1 brain image, normalised for head size) "
21   T1_SIENAX_CSF_unnorm_vol                                  brc_IDP_T1_SIENAX             5	    " IDP_T1_SIENAX_CSF_unnormalised_volume\tmm3\tfloat\tVolume of ventricular cerebrospinal fluid (from T1 brain image) "
22   T1_SIENAX_GM_norm_vol                                     brc_IDP_T1_SIENAX             6	    " IDP_T1_SIENAX_grey_normalised_volume\tmm3\tfloat\tVolume of grey matter (from T1 brain image, normalised for head size) "
23   T1_SIENAX_GM_unnorm_vol                                   brc_IDP_T1_SIENAX             7	    " IDP_T1_SIENAX_grey_unnormalised_volume\tmm3\tfloat\tVolume of grey matter (from T1 brain image) "
24   T1_SIENAX_WM_norm_vol                                     brc_IDP_T1_SIENAX             8	    " IDP_T1_SIENAX_white_normalised_volume\tmm3\tfloat\tVolume of white matter (from T1 brain image, normalised for head size) "
25   T1_SIENAX_WM_unnorm_vol                                   brc_IDP_T1_SIENAX             9	    " IDP_T1_SIENAX_white_unnormalised_volume\tmm3\tfloat\tVolume of white matter (from T1 brain image) "
26   T1_SIENAX_brain-norm_vol                                  brc_IDP_T1_SIENAX             10	    " IDP_T1_SIENAX_brain-normalised_volume\tmm3\tfloat\tVolume of brain (grey+white, from T1 brain image, normalised for head size) "
27   T1_SIENAX_brain-unnorm_vol                                brc_IDP_T1_SIENAX             11	    " IDP_T1_SIENAX_brain-unnormalised_volume\tmm3\tfloat\tVolume of brain (grey+white, from T1 brain image) "
28   T1_FIRST_left_thalamus                                    brc_IDP_T1_FIRST_vols         1	    " IDP_T1_FIRST_left_thalamus_volume\tmm3\tfloat\tVolume of left thalamus (from T1 brain image) "
29   T1_FIRST_right_thalamus                                   brc_IDP_T1_FIRST_vols         2	    " IDP_T1_FIRST_right_thalamus_volume\tmm3\tfloat\tVolume of right thalamus (from T1 brain image) "
30   T1_FIRST_left_caudate                                     brc_IDP_T1_FIRST_vols         3	    " IDP_T1_FIRST_left_caudate_volume\tmm3\tfloat\tVolume of left caudate (from T1 brain image) "
31   T1_FIRST_right_caudate                                    brc_IDP_T1_FIRST_vols         4	    " IDP_T1_FIRST_right_caudate_volume\tmm3\tfloat\tVolume of right caudate (from T1 brain image) "
32   T1_FIRST_left_putamen                                     brc_IDP_T1_FIRST_vols         5	    " IDP_T1_FIRST_left_putamen_volume\tmm3\tfloat\tVolume of left putamen (from T1 brain image) "
33   T1_FIRST_right_putamen                                    brc_IDP_T1_FIRST_vols         6	    " IDP_T1_FIRST_right_putamen_volume\tmm3\tfloat\tVolume of right putamen (from T1 brain image) "
34   T1_FIRST_left_pallidum                                    brc_IDP_T1_FIRST_vols         7	    " IDP_T1_FIRST_left_pallidum_volume\tmm3\tfloat\tVolume of left pallidum (from T1 brain image) "
35   T1_FIRST_right_pallidum                                   brc_IDP_T1_FIRST_vols         8	    " IDP_T1_FIRST_right_pallidum_volume\tmm3\tfloat\tVolume of right pallidum (from T1 brain image) "
36   T1_FIRST_left_hippocampus                                 brc_IDP_T1_FIRST_vols         9	    " IDP_T1_FIRST_left_hippocampus_volume\tmm3\tfloat\tVolume of left hippocampus (from T1 brain image) "
37   T1_FIRST_right_hippocampus                                brc_IDP_T1_FIRST_vols         10	    " IDP_T1_FIRST_right_hippocampus_volume\tmm3\tfloat\tVolume of right hippocampus (from T1 brain image) "
38   T1_FIRST_left_amygdala                                    brc_IDP_T1_FIRST_vols         11	    " IDP_T1_FIRST_left_amygdala_volume\tmm3\tfloat\tVolume of left amygdala (from T1 brain image) "
39   T1_FIRST_right_amygdala                                   brc_IDP_T1_FIRST_vols         12	    " IDP_T1_FIRST_right_amygdala_volume\tmm3\tfloat\tVolume of right amygdala (from T1 brain image) "
40   T1_FIRST_left_accumbens                                   brc_IDP_T1_FIRST_vols         13	    " IDP_T1_FIRST_left_accumbens_volume\tmm3\tfloat\tVolume of left accumbens (from T1 brain image) "
41   T1_FIRST_right_accumbens                                  brc_IDP_T1_FIRST_vols         14	    " IDP_T1_FIRST_right_accumbens_volume\tmm3\tfloat\tVolume of right accumbens (from T1 brain image) "
42   T1_FIRST_brain_stem+4th_ventricle                         brc_IDP_T1_FIRST_vols         15	    " IDP_T1_FIRST_brain_stem+4th_ventricle_volume\tmm3\tfloat\tVolume of brain stem + 4th ventricle (from T1 brain image) "
748  T1_GM_parcellation_L_Front_Pole_vol                       brc_IDP_T1_GM_parcellation    1	    " IDP_T1_GM_parcellation_L_Front_Pole_volume\tmm3\tfloat\tVolume of grey matter in Left Frontal Pole (From T1 brain image) "
749  T1_GM_parcellation_R_Front_Pole_vol                       brc_IDP_T1_GM_parcellation    2	    " IDP_T1_GM_parcellation_R_Front_Pole_volume\tmm3\tfloat\tVolume of grey matter in Right Frontal Pole (From T1 brain image) "
750  T1_GM_parcellation_L_Insula_vol                           brc_IDP_T1_GM_parcellation    3	    " IDP_T1_GM_parcellation_L_Insula_volume\tmm3\tfloat\tVolume of grey matter in Left Insular Cortex (From T1 brain image) "
751  T1_GM_parcellation_R_Insula_vol                           brc_IDP_T1_GM_parcellation    4	    " IDP_T1_GM_parcellation_R_Insula_volume\tmm3\tfloat\tVolume of grey matter in Right Insular Cortex (From T1 brain image) "
752  T1_GM_parcellation_L_Sup_Front_Gyr_vol                    brc_IDP_T1_GM_parcellation    5	    " IDP_T1_GM_parcellation_L_Sup_Front_Gyr_volume\tmm3\tfloat\tVolume of grey matter in Left Superior Frontal Gyrus (From T1 brain image) "
753  T1_GM_parcellation_R_Sup_Front_Gyr_vol                    brc_IDP_T1_GM_parcellation    6	    " IDP_T1_GM_parcellation_R_Sup_Front_Gyr_volume\tmm3\tfloat\tVolume of grey matter in Right Superior Frontal Gyrus (From T1 brain image) "
754  T1_GM_parcellation_L_Mid_Front_Gyr_vol                    brc_IDP_T1_GM_parcellation    7	    " IDP_T1_GM_parcellation_L_Mid_Front_Gyr_volume\tmm3\tfloat\tVolume of grey matter in Left Middle Frontal Gyrus (From T1 brain image) "
755  T1_GM_parcellation_R_Mid_Front_Gyr_vol                    brc_IDP_T1_GM_parcellation    8	    " IDP_T1_GM_parcellation_R_Mid_Front_Gyr_volume\tmm3\tfloat\tVolume of grey matter in Right Middle Frontal Gyrus (From T1 brain image) "
756  T1_GM_parcellation_L_Inf_Front_Gyr_pars_triangularis_vol  brc_IDP_T1_GM_parcellation    9	    " IDP_T1_GM_parcellation_L_Inf_Front_Gyr_pars_triangularis_volume\tmm3\tfloat\tVolume of grey matter in Left Inferior Frontal Gyrus, pars triangularis (From T1 brain image) "
757  T1_GM_parcellation_R_Inf_Front_Gyr_pars_triangularis_vol  brc_IDP_T1_GM_parcellation    10	    " IDP_T1_GM_parcellation_R_Inf_Front_Gyr_pars_triangularis_volume\tmm3\tfloat\tVolume of grey matter in Right Inferior Frontal Gyrus, pars triangularis (From T1 brain image) "
758  T1_GM_parcellation_L_Inf_Front_Gyr_pars_opercularis_vol   brc_IDP_T1_GM_parcellation    11	    " IDP_T1_GM_parcellation_L_Inf_Front_Gyr_pars_opercularis_volume\tmm3\tfloat\tVolume of grey matter in Left Inferior Frontal Gyrus, pars opercularis (From T1 brain image) "
759  T1_GM_parcellation_R_Inf_Front_Gyr_pars_opercularis_vol   brc_IDP_T1_GM_parcellation    12	    " IDP_T1_GM_parcellation_R_Inf_Front_Gyr_pars_opercularis_volume\tmm3\tfloat\tVolume of grey matter in Right Inferior Frontal Gyrus, pars opercularis (From T1 brain image) "
760  T1_GM_parcellation_L_Precentral_Gyr_vol                   brc_IDP_T1_GM_parcellation    13	    " IDP_T1_GM_parcellation_L_Precentral_Gyr_volume\tmm3\tfloat\tVolume of grey matter in Left Precentral Gyrus (From T1 brain image) "
761  T1_GM_parcellation_R_Precentral_Gyr_vol                   brc_IDP_T1_GM_parcellation    14	    " IDP_T1_GM_parcellation_R_Precentral_Gyr_volume\tmm3\tfloat\tVolume of grey matter in Right Precentral Gyrus (From T1 brain image) "
762  T1_GM_parcellation_L_Temp_Pole_vol                        brc_IDP_T1_GM_parcellation    15	    " IDP_T1_GM_parcellation_L_Temp_Pole_volume\tmm3\tfloat\tVolume of grey matter in Left Temporal Pole (From T1 brain image) "
763  T1_GM_parcellation_R_Temp_Pole_vol                        brc_IDP_T1_GM_parcellation    16	    " IDP_T1_GM_parcellation_R_Temp_Pole_volume\tmm3\tfloat\tVolume of grey matter in Right Temporal Pole (From T1 brain image) "
764  T1_GM_parcellation_L_Sup_Temp_Gyr_ant_vol                 brc_IDP_T1_GM_parcellation    17	    " IDP_T1_GM_parcellation_L_Sup_Temp_Gyr_ant_volume\tmm3\tfloat\tVolume of grey matter in Left Superior Temporal Gyrus, anterior division (From T1 brain image) "
765  T1_GM_parcellation_R_Sup_Temp_Gyr_ant_vol                 brc_IDP_T1_GM_parcellation    18	    " IDP_T1_GM_parcellation_R_Sup_Temp_Gyr_ant_volume\tmm3\tfloat\tVolume of grey matter in Right Superior Temporal Gyrus, anterior division (From T1 brain image) "
766  T1_GM_parcellation_L_Sup_Temp_Gyr_post_vol                brc_IDP_T1_GM_parcellation    19	    " IDP_T1_GM_parcellation_L_Sup_Temp_Gyr_post_volume\tmm3\tfloat\tVolume of grey matter in Left Superior Temporal Gyrus, posterior division (From T1 brain image) "
767  T1_GM_parcellation_R_Sup_Temp_Gyr_post_vol                brc_IDP_T1_GM_parcellation    20	    " IDP_T1_GM_parcellation_R_Sup_Temp_Gyr_post_volume\tmm3\tfloat\tVolume of grey matter in Right Superior Temporal Gyrus, posterior division (From T1 brain image) "
768  T1_GM_parcellation_L_Mid_Temp_Gyr_ant_vol                 brc_IDP_T1_GM_parcellation    21	    " IDP_T1_GM_parcellation_L_Mid_Temp_Gyr_ant_volume\tmm3\tfloat\tVolume of grey matter in Left Middle Temporal Gyrus, anterior division (From T1 brain image) "
769  T1_GM_parcellation_R_Mid_Temp_Gyr_ant_vol                 brc_IDP_T1_GM_parcellation    22	    " IDP_T1_GM_parcellation_R_Mid_Temp_Gyr_ant_volume\tmm3\tfloat\tVolume of grey matter in Right Middle Temporal Gyrus, anterior division (From T1 brain image) "
770  T1_GM_parcellation_L_Mid_Temp_Gyr_post_vol                brc_IDP_T1_GM_parcellation    23	    " IDP_T1_GM_parcellation_L_Mid_Temp_Gyr_post_volume\tmm3\tfloat\tVolume of grey matter in Left Middle Temporal Gyrus, posterior division (From T1 brain image) "
771  T1_GM_parcellation_R_Mid_Temp_Gyr_post_vol                brc_IDP_T1_GM_parcellation    24	    " IDP_T1_GM_parcellation_R_Mid_Temp_Gyr_post_volume\tmm3\tfloat\tVolume of grey matter in Right Middle Temporal Gyrus, posterior division (From T1 brain image) "
772  T1_GM_parcellation_L_Mid_Temp_Gyr_temporoOcc_part_vol     brc_IDP_T1_GM_parcellation    25	    " IDP_T1_GM_parcellation_L_Mid_Temp_Gyr_temporoOcc_part_volume\tmm3\tfloat\tVolume of grey matter in Left Middle Temporal Gyrus, temporooccipital part (From T1 brain image) "
773  T1_GM_parcellation_R_Mid_Temp_Gyr_temporoOcc_part_vol     brc_IDP_T1_GM_parcellation    26	    " IDP_T1_GM_parcellation_R_Mid_Temp_Gyr_temporoOcc_part_volume\tmm3\tfloat\tVolume of grey matter in Right Middle Temporal Gyrus, temporooccipital part (From T1 brain image) "
774  T1_GM_parcellation_L_Inf_Temp_Gyr_ant_vol                 brc_IDP_T1_GM_parcellation    27	    " IDP_T1_GM_parcellation_L_Inf_Temp_Gyr_ant_volume\tmm3\tfloat\tVolume of grey matter in Left Inferior Temporal Gyrus, anterior division (From T1 brain image) "
775  T1_GM_parcellation_R_Inf_Temp_Gyr_ant_vol                 brc_IDP_T1_GM_parcellation    28	    " IDP_T1_GM_parcellation_R_Inf_Temp_Gyr_ant_volume\tmm3\tfloat\tVolume of grey matter in Right Inferior Temporal Gyrus, anterior division (From T1 brain image) "
776  T1_GM_parcellation_L_Inf_Temp_Gyr_post_vol                brc_IDP_T1_GM_parcellation    29	    " IDP_T1_GM_parcellation_L_Inf_Temp_Gyr_post_volume\tmm3\tfloat\tVolume of grey matter in Left Inferior Temporal Gyrus, posterior division (From T1 brain image) "
777  T1_GM_parcellation_R_Inf_Temp_Gyr_post_vol                brc_IDP_T1_GM_parcellation    30	    " IDP_T1_GM_parcellation_R_Inf_Temp_Gyr_post_volume\tmm3\tfloat\tVolume of grey matter in Right Inferior Temporal Gyrus, posterior division (From T1 brain image) "
778  T1_GM_parcellation_L_Inf_Temp_Gyr_temporoOcc_part_vol     brc_IDP_T1_GM_parcellation    31	    " IDP_T1_GM_parcellation_L_Inf_Temp_Gyr_temporoOcc_part_volume\tmm3\tfloat\tVolume of grey matter in Left Inferior Temporal Gyrus, temporooccipital part (From T1 brain image) "
779  T1_GM_parcellation_R_Inf_Temp_Gyr_temporoOcc_part_vol     brc_IDP_T1_GM_parcellation    32	    " IDP_T1_GM_parcellation_R_Inf_Temp_Gyr_temporoOcc_part_volume\tmm3\tfloat\tVolume of grey matter in Right Inferior Temporal Gyrus, temporooccipital part (From T1 brain image) "
780  T1_GM_parcellation_L_Postcentral_Gyr_vol                  brc_IDP_T1_GM_parcellation    33	    " IDP_T1_GM_parcellation_L_Postcentral_Gyr_volume\tmm3\tfloat\tVolume of grey matter in Left Postcentral Gyrus (From T1 brain image) "
781  T1_GM_parcellation_R_Postcentral_Gyr_vol                  brc_IDP_T1_GM_parcellation    34	    " IDP_T1_GM_parcellation_R_Postcentral_Gyr_volume\tmm3\tfloat\tVolume of grey matter in Right Postcentral Gyrus (From T1 brain image) "
782  T1_GM_parcellation_L_Sup_Parietal_Lobule_vol              brc_IDP_T1_GM_parcellation    35	    " IDP_T1_GM_parcellation_L_Sup_Parietal_Lobule_volume\tmm3\tfloat\tVolume of grey matter in Left Superior Parietal Lobule (From T1 brain image) "
783  T1_GM_parcellation_R_Sup_Parietal_Lobule_vol              brc_IDP_T1_GM_parcellation    36	    " IDP_T1_GM_parcellation_R_Sup_Parietal_Lobule_volume\tmm3\tfloat\tVolume of grey matter in Right Superior Parietal Lobule (From T1 brain image) "
784  T1_GM_parcellation_L_Supramarginal_Gyr_ant_vol            brc_IDP_T1_GM_parcellation    37	    " IDP_T1_GM_parcellation_L_Supramarginal_Gyr_ant_volume\tmm3\tfloat\tVolume of grey matter in Left Supramarginal Gyrus, anterior division (From T1 brain image) "
785  T1_GM_parcellation_R_Supramarginal_Gyr_ant_vol            brc_IDP_T1_GM_parcellation    38	    " IDP_T1_GM_parcellation_R_Supramarginal_Gyr_ant_volume\tmm3\tfloat\tVolume of grey matter in Right Supramarginal Gyrus, anterior division (From T1 brain image) "
786  T1_GM_parcellation_L_Supramarginal_Gyr_post_vol           brc_IDP_T1_GM_parcellation    39	    " IDP_T1_GM_parcellation_L_Supramarginal_Gyr_post_volume\tmm3\tfloat\tVolume of grey matter in Left Supramarginal Gyrus, posterior division (From T1 brain image) "
787  T1_GM_parcellation_R_Supramarginal_Gyr_post_vol           brc_IDP_T1_GM_parcellation    40	    " IDP_T1_GM_parcellation_R_Supramarginal_Gyr_post_volume\tmm3\tfloat\tVolume of grey matter in Right Supramarginal Gyrus, posterior division (From T1 brain image) "
788  T1_GM_parcellation_L_Angular_Gyr_vol                      brc_IDP_T1_GM_parcellation    41	    " IDP_T1_GM_parcellation_L_Angular_Gyr_volume\tmm3\tfloat\tVolume of grey matter in Left Angular Gyrus (From T1 brain image) "
789  T1_GM_parcellation_R_Angular_Gyr_vol                      brc_IDP_T1_GM_parcellation    42	    " IDP_T1_GM_parcellation_R_Angular_Gyr_volume\tmm3\tfloat\tVolume of grey matter in Right Angular Gyrus (From T1 brain image) "
790  T1_GM_parcellation_L_Lateral_Occ_Sup_vol                  brc_IDP_T1_GM_parcellation    43	    " IDP_T1_GM_parcellation_L_Lateral_Occ_Sup_volume\tmm3\tfloat\tVolume of grey matter in Left Lateral Occipital Cortex, superior division (From T1 brain image) "
791  T1_GM_parcellation_R_Lateral_Occ_Sup_vol                  brc_IDP_T1_GM_parcellation    44	    " IDP_T1_GM_parcellation_R_Lateral_Occ_Sup_volume\tmm3\tfloat\tVolume of grey matter in Right Lateral Occipital Cortex, superior division (From T1 brain image) "
792  T1_GM_parcellation_L_Lateral_Occ_Inf_vol                  brc_IDP_T1_GM_parcellation    45	    " IDP_T1_GM_parcellation_L_Lateral_Occ_Inf_volume\tmm3\tfloat\tVolume of grey matter in Left Lateral Occipital Cortex, inferior division (From T1 brain image) "
793  T1_GM_parcellation_R_Lateral_Occ_Inf_vol                  brc_IDP_T1_GM_parcellation    46	    " IDP_T1_GM_parcellation_R_Lateral_Occ_Inf_volume\tmm3\tfloat\tVolume of grey matter in Right Lateral Occipital Cortex, inferior division (From T1 brain image) "
794  T1_GM_parcellation_L_Intracalcarine_vol                   brc_IDP_T1_GM_parcellation    47	    " IDP_T1_GM_parcellation_L_Intracalcarine_volume\tmm3\tfloat\tVolume of grey matter in Left Intracalcarine Cortex (From T1 brain image) "
795  T1_GM_parcellation_R_Intracalcarine_vol                   brc_IDP_T1_GM_parcellation    48	    " IDP_T1_GM_parcellation_R_Intracalcarine_volume\tmm3\tfloat\tVolume of grey matter in Right Intracalcarine Cortex (From T1 brain image) "
796  T1_GM_parcellation_L_Front_Medial_vol                     brc_IDP_T1_GM_parcellation    49	    " IDP_T1_GM_parcellation_L_Front_Medial_volume\tmm3\tfloat\tVolume of grey matter in Left Frontal Medial Cortex (From T1 brain image) "
797  T1_GM_parcellation_R_Front_Medial_vol                     brc_IDP_T1_GM_parcellation    50	    " IDP_T1_GM_parcellation_R_Front_Medial_volume\tmm3\tfloat\tVolume of grey matter in Right Frontal Medial Cortex (From T1 brain image) "
798  T1_GM_parcellation_L_Juxtapositional_Lobule_vol           brc_IDP_T1_GM_parcellation    51	    " IDP_T1_GM_parcellation_L_Juxtapositional_Lobule_volume\tmm3\tfloat\tVolume of grey matter in Left Juxtapositional Lobule Cortex (formerly Supplementary Motor Cortex) (From T1 brain image) "
799  T1_GM_parcellation_R_Juxtapositional_Lobule_vol           brc_IDP_T1_GM_parcellation    52	    " IDP_T1_GM_parcellation_R_Juxtapositional_Lobule_volume\tmm3\tfloat\tVolume of grey matter in Right Juxtapositional Lobule Cortex (formerly Supplementary Motor Cortex) (From T1 brain image) "
800  T1_GM_parcellation_L_Subcallosal_vol                      brc_IDP_T1_GM_parcellation    53	    " IDP_T1_GM_parcellation_L_Subcallosal_volume\tmm3\tfloat\tVolume of grey matter in Left Subcallosal Cortex (From T1 brain image) "
801  T1_GM_parcellation_R_Subcallosal_vol                      brc_IDP_T1_GM_parcellation    54	    " IDP_T1_GM_parcellation_R_Subcallosal_volume\tmm3\tfloat\tVolume of grey matter in Right Subcallosal Cortex (From T1 brain image) "
802  T1_GM_parcellation_L_Paracingulate_Gyr_vol                brc_IDP_T1_GM_parcellation    55	    " IDP_T1_GM_parcellation_L_Paracingulate_Gyr_volume\tmm3\tfloat\tVolume of grey matter in Left Paracingulate Gyrus (From T1 brain image) "
803  T1_GM_parcellation_R_Paracingulate_Gyr_vol                brc_IDP_T1_GM_parcellation    56	    " IDP_T1_GM_parcellation_R_Paracingulate_Gyr_volume\tmm3\tfloat\tVolume of grey matter in Right Paracingulate Gyrus (From T1 brain image) "
804  T1_GM_parcellation_L_Cingulate_Gyr_ant_vol                brc_IDP_T1_GM_parcellation    57	    " IDP_T1_GM_parcellation_L_Cingulate_Gyr_ant_volume\tmm3\tfloat\tVolume of grey matter in Left Cingulate Gyrus, anterior division (From T1 brain image) "
805  T1_GM_parcellation_R_Cingulate_Gyr_ant_vol                brc_IDP_T1_GM_parcellation    58	    " IDP_T1_GM_parcellation_R_Cingulate_Gyr_ant_volume\tmm3\tfloat\tVolume of grey matter in Right Cingulate Gyrus, anterior division (From T1 brain image) "
806  T1_GM_parcellation_L_Cingulate_Gyr_post_vol               brc_IDP_T1_GM_parcellation    59	    " IDP_T1_GM_parcellation_L_Cingulate_Gyr_post_volume\tmm3\tfloat\tVolume of grey matter in Left Cingulate Gyrus, posterior division (From T1 brain image) "
807  T1_GM_parcellation_R_Cingulate_Gyr_post_vol               brc_IDP_T1_GM_parcellation    60	    " IDP_T1_GM_parcellation_R_Cingulate_Gyr_post_volume\tmm3\tfloat\tVolume of grey matter in Right Cingulate Gyrus, posterior division (From T1 brain image) "
808  T1_GM_parcellation_L_Precuneous_vol                       brc_IDP_T1_GM_parcellation    61	    " IDP_T1_GM_parcellation_L_Precuneous_volume\tmm3\tfloat\tVolume of grey matter in Left Precuneous Cortex (From T1 brain image) "
809  T1_GM_parcellation_R_Precuneous_vol                       brc_IDP_T1_GM_parcellation    62	    " IDP_T1_GM_parcellation_R_Precuneous_volume\tmm3\tfloat\tVolume of grey matter in Right Precuneous Cortex (From T1 brain image) "
810  T1_GM_parcellation_L_Cuneal_vol                           brc_IDP_T1_GM_parcellation    63	    " IDP_T1_GM_parcellation_L_Cuneal_volume\tmm3\tfloat\tVolume of grey matter in Left Cuneal Cortex (From T1 brain image) "
811  T1_GM_parcellation_R_Cuneal_vol                           brc_IDP_T1_GM_parcellation    64	    " IDP_T1_GM_parcellation_R_Cuneal_volume\tmm3\tfloat\tVolume of grey matter in Right Cuneal Cortex (From T1 brain image) "
812  T1_GM_parcellation_L_Front_Orbital_vol                    brc_IDP_T1_GM_parcellation    65	    " IDP_T1_GM_parcellation_L_Front_Orbital_volume\tmm3\tfloat\tVolume of grey matter in Left Frontal Orbital Cortex (From T1 brain image) "
813  T1_GM_parcellation_R_Front_Orbital_vol                    brc_IDP_T1_GM_parcellation    66	    " IDP_T1_GM_parcellation_R_Front_Orbital_volume\tmm3\tfloat\tVolume of grey matter in Right Frontal Orbital Cortex (From T1 brain image) "
814  T1_GM_parcellation_L_Parahippocampal_Gyr_ant_vol          brc_IDP_T1_GM_parcellation    67	    " IDP_T1_GM_parcellation_L_Parahippocampal_Gyr_ant_volume\tmm3\tfloat\tVolume of grey matter in Left Parahippocampal Gyrus, anterior division (From T1 brain image) "
815  T1_GM_parcellation_R_Parahippocampal_Gyr_ant_vol          brc_IDP_T1_GM_parcellation    68	    " IDP_T1_GM_parcellation_R_Parahippocampal_Gyr_ant_volume\tmm3\tfloat\tVolume of grey matter in Right Parahippocampal Gyrus, anterior division (From T1 brain image) "
816  T1_GM_parcellation_L_Parahippocampal_Gyr_post_vol         brc_IDP_T1_GM_parcellation    69	    " IDP_T1_GM_parcellation_L_Parahippocampal_Gyr_post_volume\tmm3\tfloat\tVolume of grey matter in Left Parahippocampal Gyrus, posterior division (From T1 brain image) "
817  T1_GM_parcellation_R_Parahippocampal_Gyr_post_vol         brc_IDP_T1_GM_parcellation    70	    " IDP_T1_GM_parcellation_R_Parahippocampal_Gyr_post_volume\tmm3\tfloat\tVolume of grey matter in Right Parahippocampal Gyrus, posterior division (From T1 brain image) "
818  T1_GM_parcellation_L_Lingual_Gyr_vol                      brc_IDP_T1_GM_parcellation    71	    " IDP_T1_GM_parcellation_L_Lingual_Gyr_volume\tmm3\tfloat\tVolume of grey matter in Left Lingual Gyrus (From T1 brain image) "
819  T1_GM_parcellation_R_Lingual_Gyr_vol                      brc_IDP_T1_GM_parcellation    72	    " IDP_T1_GM_parcellation_R_Lingual_Gyr_volume\tmm3\tfloat\tVolume of grey matter in Right Lingual Gyrus (From T1 brain image) "
820  T1_GM_parcellation_L_Temp_Fusiform_ant_vol                brc_IDP_T1_GM_parcellation    73	    " IDP_T1_GM_parcellation_L_Temp_Fusiform_ant_volume\tmm3\tfloat\tVolume of grey matter in Left Temporal Fusiform Cortex, anterior division (From T1 brain image) "
821  T1_GM_parcellation_R_Temp_Fusiform_ant_vol                brc_IDP_T1_GM_parcellation    74	    " IDP_T1_GM_parcellation_R_Temp_Fusiform_ant_volume\tmm3\tfloat\tVolume of grey matter in Right Temporal Fusiform Cortex, anterior division (From T1 brain image) "
822  T1_GM_parcellation_L_Temp_Fusiform_post_vol               brc_IDP_T1_GM_parcellation    75	    " IDP_T1_GM_parcellation_L_Temp_Fusiform_post_volume\tmm3\tfloat\tVolume of grey matter in Left Temporal Fusiform Cortex, posterior division (From T1 brain image) "
823  T1_GM_parcellation_R_Temp_Fusiform_post_vol               brc_IDP_T1_GM_parcellation    76	    " IDP_T1_GM_parcellation_R_Temp_Fusiform_post_volume\tmm3\tfloat\tVolume of grey matter in Right Temporal Fusiform Cortex, posterior division (From T1 brain image) "
824  T1_GM_parcellation_L_Temp_Occ_Fusiform_vol                brc_IDP_T1_GM_parcellation    77	    " IDP_T1_GM_parcellation_L_Temp_Occ_Fusiform_volume\tmm3\tfloat\tVolume of grey matter in Left Temporal Occipital Fusiform Cortex (From T1 brain image) "
825  T1_GM_parcellation_R_Temp_Occ_Fusiform_vol                brc_IDP_T1_GM_parcellation    78	    " IDP_T1_GM_parcellation_R_Temp_Occ_Fusiform_volume\tmm3\tfloat\tVolume of grey matter in Right Temporal Occipital Fusiform Cortex (From T1 brain image) "
826  T1_GM_parcellation_L_Occ_Fusiform_Gyr_vol                 brc_IDP_T1_GM_parcellation    79	    " IDP_T1_GM_parcellation_L_Occ_Fusiform_Gyr_volume\tmm3\tfloat\tVolume of grey matter in Left Occipital Fusiform Gyrus (From T1 brain image) "
827  T1_GM_parcellation_R_Occ_Fusiform_Gyr_vol                 brc_IDP_T1_GM_parcellation    80	    " IDP_T1_GM_parcellation_R_Occ_Fusiform_Gyr_volume\tmm3\tfloat\tVolume of grey matter in Right Occipital Fusiform Gyrus (From T1 brain image) "
828  T1_GM_parcellation_L_Front_Operculum_vol                  brc_IDP_T1_GM_parcellation    81	    " IDP_T1_GM_parcellation_L_Front_Operculum_volume\tmm3\tfloat\tVolume of grey matter in Left Frontal Operculum Cortex (From T1 brain image) "
829  T1_GM_parcellation_R_Front_Operculum_vol                  brc_IDP_T1_GM_parcellation    82	    " IDP_T1_GM_parcellation_R_Front_Operculum_volume\tmm3\tfloat\tVolume of grey matter in Right Frontal Operculum Cortex (From T1 brain image) "
830  T1_GM_parcellation_L_Central_Opercular_vol                brc_IDP_T1_GM_parcellation    83	    " IDP_T1_GM_parcellation_L_Central_Opercular_volume\tmm3\tfloat\tVolume of grey matter in Left Central Opercular Cortex (From T1 brain image) "
831  T1_GM_parcellation_R_Central_Opercular_vol                brc_IDP_T1_GM_parcellation    84	    " IDP_T1_GM_parcellation_R_Central_Opercular_volume\tmm3\tfloat\tVolume of grey matter in Right Central Opercular Cortex (From T1 brain image) "
832  T1_GM_parcellation_L_Parietal_Operculum_vol               brc_IDP_T1_GM_parcellation    85	    " IDP_T1_GM_parcellation_L_Parietal_Operculum_volume\tmm3\tfloat\tVolume of grey matter in Left Parietal Operculum Cortex (From T1 brain image) "
833  T1_GM_parcellation_R_Parietal_Operculum_vol               brc_IDP_T1_GM_parcellation    86	    " IDP_T1_GM_parcellation_R_Parietal_Operculum_volume\tmm3\tfloat\tVolume of grey matter in Right Parietal Operculum Cortex (From T1 brain image) "
834  T1_GM_parcellation_L_Planum_Polare_vol                    brc_IDP_T1_GM_parcellation    87	    " IDP_T1_GM_parcellation_L_Planum_Polare_volume\tmm3\tfloat\tVolume of grey matter in Left Planum Polare (From T1 brain image) "
835  T1_GM_parcellation_R_Planum_Polare_vol                    brc_IDP_T1_GM_parcellation    88	    " IDP_T1_GM_parcellation_R_Planum_Polare_volume\tmm3\tfloat\tVolume of grey matter in Right Planum Polare (From T1 brain image) "
836  T1_GM_parcellation_L_Heschl_Gyr_vol                       brc_IDP_T1_GM_parcellation    89	    " IDP_T1_GM_parcellation_L_Heschl_Gyr_volume\tmm3\tfloat\tVolume of grey matter in Left Heschl's Gyrus (includes H1 and H2) (From T1 brain image) "
837  T1_GM_parcellation_R_Heschl_Gyr_vol                       brc_IDP_T1_GM_parcellation    90	    " IDP_T1_GM_parcellation_R_Heschl_Gyr_volume\tmm3\tfloat\tVolume of grey matter in Right Heschl's Gyrus (includes H1 and H2) (From T1 brain image) "
838  T1_GM_parcellation_L_Planum_Tempe_vol                     brc_IDP_T1_GM_parcellation    91	    " IDP_T1_GM_parcellation_L_Planum_Tempe_volume\tmm3\tfloat\tVolume of grey matter in Left Planum Temporale (From T1 brain image) "
839  T1_GM_parcellation_R_Planum_Tempe_vol                     brc_IDP_T1_GM_parcellation    92	    " IDP_T1_GM_parcellation_R_Planum_Tempe_volume\tmm3\tfloat\tVolume of grey matter in Right Planum Temporale (From T1 brain image) "
840  T1_GM_parcellation_L_Supracalcarine_vol                   brc_IDP_T1_GM_parcellation    93	    " IDP_T1_GM_parcellation_L_Supracalcarine_volume\tmm3\tfloat\tVolume of grey matter in Left Supracalcarine Cortex (From T1 brain image) "
841  T1_GM_parcellation_R_Supracalcarine_vol                   brc_IDP_T1_GM_parcellation    94	    " IDP_T1_GM_parcellation_R_Supracalcarine_volume\tmm3\tfloat\tVolume of grey matter in Right Supracalcarine Cortex (From T1 brain image) "
842  T1_GM_parcellation_L_Occ_Pole_vol                         brc_IDP_T1_GM_parcellation    95	    " IDP_T1_GM_parcellation_L_Occ_Pole_volume\tmm3\tfloat\tVolume of grey matter in Left Occipital Pole (From T1 brain image) "
843  T1_GM_parcellation_R_Occ_Pole_vol                         brc_IDP_T1_GM_parcellation    96	    " IDP_T1_GM_parcellation_R_Occ_Pole_volume\tmm3\tfloat\tVolume of grey matter in Right Occipital Pole (From T1 brain image) "
844  T1_GM_parcellation_L_Thalamus_vol                         brc_IDP_T1_GM_parcellation    97	    " IDP_T1_GM_parcellation_L_Thalamus_volume\tmm3\tfloat\tVolume of grey matter in Left Thalamus (From T1 brain image) "
845  T1_GM_parcellation_R_Thalamus_vol                         brc_IDP_T1_GM_parcellation    98	    " IDP_T1_GM_parcellation_R_Thalamus_volume\tmm3\tfloat\tVolume of grey matter in Right Thalamus (From T1 brain image) "
846  T1_GM_parcellation_L_Caudate_vol                          brc_IDP_T1_GM_parcellation    99	    " IDP_T1_GM_parcellation_L_Caudate_volume\tmm3\tfloat\tVolume of grey matter in Left Caudate (From T1 brain image) "
847  T1_GM_parcellation_R_Caudate_vol                          brc_IDP_T1_GM_parcellation    100	    " IDP_T1_GM_parcellation_R_Caudate_volume\tmm3\tfloat\tVolume of grey matter in Right Caudate (From T1 brain image) "
848  T1_GM_parcellation_L_Putamen_vol                          brc_IDP_T1_GM_parcellation    101	    " IDP_T1_GM_parcellation_L_Putamen_volume\tmm3\tfloat\tVolume of grey matter in Left Putamen (From T1 brain image) "
849  T1_GM_parcellation_R_Putamen_vol                          brc_IDP_T1_GM_parcellation    102	    " IDP_T1_GM_parcellation_R_Putamen_volume\tmm3\tfloat\tVolume of grey matter in Right Putamen (From T1 brain image) "
850  T1_GM_parcellation_L_Pallidum_vol                         brc_IDP_T1_GM_parcellation    103	    " IDP_T1_GM_parcellation_L_Pallidum_volume\tmm3\tfloat\tVolume of grey matter in Left Pallidum (From T1 brain image) "
851  T1_GM_parcellation_R_Pallidum_vol                         brc_IDP_T1_GM_parcellation    104	    " IDP_T1_GM_parcellation_R_Pallidum_volume\tmm3\tfloat\tVolume of grey matter in Right Pallidum (From T1 brain image) "
852  T1_GM_parcellation_L_Hippocampus_vol                      brc_IDP_T1_GM_parcellation    105	    " IDP_T1_GM_parcellation_L_Hippocampus_volume\tmm3\tfloat\tVolume of grey matter in Left Hippocampus (From T1 brain image) "
853  T1_GM_parcellation_R_Hippocampus_vol                      brc_IDP_T1_GM_parcellation    106	    " IDP_T1_GM_parcellation_R_Hippocampus_volume\tmm3\tfloat\tVolume of grey matter in Right Hippocampus (From T1 brain image) "
854  T1_GM_parcellation_L_Amygdala_vol                         brc_IDP_T1_GM_parcellation    107	    " IDP_T1_GM_parcellation_L_Amygdala_volume\tmm3\tfloat\tVolume of grey matter in Left Amygdala (From T1 brain image) "
855  T1_GM_parcellation_R_Amygdala_vol                         brc_IDP_T1_GM_parcellation    108	    " IDP_T1_GM_parcellation_R_Amygdala_volume\tmm3\tfloat\tVolume of grey matter in Right Amygdala (From T1 brain image) "
856  T1_GM_parcellation_L_Vent_Striatum_vol                    brc_IDP_T1_GM_parcellation    109	    " IDP_T1_GM_parcellation_L_Vent_Striatum_volume\tmm3\tfloat\tVolume of grey matter in Left Ventral Striatum (From T1 brain image) "
857  T1_GM_parcellation_R_Vent_Striatum_vol                    brc_IDP_T1_GM_parcellation    110	    " IDP_T1_GM_parcellation_R_Vent_Striatum_volume\tmm3\tfloat\tVolume of grey matter in Right Ventral Striatum (From T1 brain image) "
858  T1_GM_parcellation_Brain-Stem_vol                         brc_IDP_T1_GM_parcellation    111	    " IDP_T1_GM_parcellation_Brain-Stem_volume\tmm3\tfloat\tVolume of grey matter in Brain-Stem (From T1 brain image) "
859  T1_GM_parcellation_L_I-IV_Cerebellum_vol                  brc_IDP_T1_GM_parcellation    112	    " IDP_T1_GM_parcellation_L_I-IV_Cerebellum_volume\tmm3\tfloat\tVolume of grey matter in Left I-IV Cerebellum (From T1 brain image) "
860  T1_GM_parcellation_R_I-IV_Cerebellum_vol                  brc_IDP_T1_GM_parcellation    113	    " IDP_T1_GM_parcellation_R_I-IV_Cerebellum_volume\tmm3\tfloat\tVolume of grey matter in Right I-IV Cerebellum (From T1 brain image) "
861  T1_GM_parcellation_L_V_Cerebellum_vol                     brc_IDP_T1_GM_parcellation    114	    " IDP_T1_GM_parcellation_L_V_Cerebellum_volume\tmm3\tfloat\tVolume of grey matter in Left V Cerebellum (From T1 brain image) "
862  T1_GM_parcellation_R_V_Cerebellum_vol                     brc_IDP_T1_GM_parcellation    115	    " IDP_T1_GM_parcellation_R_V_Cerebellum_volume\tmm3\tfloat\tVolume of grey matter in Right V Cerebellum (From T1 brain image) "
863  T1_GM_parcellation_L_VI_Cerebellum_vol                    brc_IDP_T1_GM_parcellation    116	    " IDP_T1_GM_parcellation_L_VI_Cerebellum_volume\tmm3\tfloat\tVolume of grey matter in Left VI Cerebellum (From T1 brain image) "
864  T1_GM_parcellation_Vermis_VI_Cerebellum_vol               brc_IDP_T1_GM_parcellation    117	    " IDP_T1_GM_parcellation_Vermis_VI_Cerebellum_volume\tmm3\tfloat\tVolume of grey matter in Vermis VI Cerebellum (From T1 brain image) "
865  T1_GM_parcellation_R_VI_Cerebellum_vol                    brc_IDP_T1_GM_parcellation    118	    " IDP_T1_GM_parcellation_R_VI_Cerebellum_volume\tmm3\tfloat\tVolume of grey matter in Right VI Cerebellum (From T1 brain image) "
866  T1_GM_parcellation_L_Crus_I_Cerebellum_vol                brc_IDP_T1_GM_parcellation    119	    " IDP_T1_GM_parcellation_L_Crus_I_Cerebellum_volume\tmm3\tfloat\tVolume of grey matter in Left Crus I Cerebellum (From T1 brain image) "
867  T1_GM_parcellation_Vermis_Crus_I_Cerebellum_vol           brc_IDP_T1_GM_parcellation    120	    " IDP_T1_GM_parcellation_Vermis_Crus_I_Cerebellum_volume\tmm3\tfloat\tVolume of grey matter in Vermis Crus I Cerebellum (From T1 brain image) "
868  T1_GM_parcellation_R_Crus_I_Cerebellum_vol                brc_IDP_T1_GM_parcellation    121	    " IDP_T1_GM_parcellation_R_Crus_I_Cerebellum_volume\tmm3\tfloat\tVolume of grey matter in Right Crus I Cerebellum (From T1 brain image) "
869  T1_GM_parcellation_L_Crus_II_Cerebellum_vol               brc_IDP_T1_GM_parcellation    122	    " IDP_T1_GM_parcellation_L_Crus_II_Cerebellum_volume\tmm3\tfloat\tVolume of grey matter in Left Crus II Cerebellum (From T1 brain image) "
870  T1_GM_parcellation_Vermis_Crus_II_Cerebellum_vol          brc_IDP_T1_GM_parcellation    123	    " IDP_T1_GM_parcellation_Vermis_Crus_II_Cerebellum_volume\tmm3\tfloat\tVolume of grey matter in Vermis Crus II Cerebellum (From T1 brain image) "
871  T1_GM_parcellation_R_Crus_II_Cerebellum_vol               brc_IDP_T1_GM_parcellation    124	    " IDP_T1_GM_parcellation_R_Crus_II_Cerebellum_volume\tmm3\tfloat\tVolume of grey matter in Right Crus II Cerebellum (From T1 brain image) "
872  T1_GM_parcellation_L_VIIb_Cerebellum_vol                  brc_IDP_T1_GM_parcellation    125	    " IDP_T1_GM_parcellation_L_VIIb_Cerebellum_volume\tmm3\tfloat\tVolume of grey matter in Left VIIb Cerebellum (From T1 brain image) "
873  T1_GM_parcellation_Vermis_VIIb_Cerebellum_vol             brc_IDP_T1_GM_parcellation    126	    " IDP_T1_GM_parcellation_Vermis_VIIb_Cerebellum_volume\tmm3\tfloat\tVolume of grey matter in Vermis VIIb Cerebellum (From T1 brain image) "
874  T1_GM_parcellation_R_VIIb_Cerebellum_vol                  brc_IDP_T1_GM_parcellation    127	    " IDP_T1_GM_parcellation_R_VIIb_Cerebellum_volume\tmm3\tfloat\tVolume of grey matter in Right VIIb Cerebellum (From T1 brain image) "
875  T1_GM_parcellation_L_VIIIa_Cerebellum_vol                 brc_IDP_T1_GM_parcellation    128	    " IDP_T1_GM_parcellation_L_VIIIa_Cerebellum_volume\tmm3\tfloat\tVolume of grey matter in Left VIIIa Cerebellum (From T1 brain image) "
876  T1_GM_parcellation_Vermis_VIIIa_Cerebellum_vol            brc_IDP_T1_GM_parcellation    129	    " IDP_T1_GM_parcellation_Vermis_VIIIa_Cerebellum_volume\tmm3\tfloat\tVolume of grey matter in Vermis VIIIa Cerebellum (From T1 brain image) "
877  T1_GM_parcellation_R_VIIIa_Cerebellum_vol                 brc_IDP_T1_GM_parcellation    130	    " IDP_T1_GM_parcellation_R_VIIIa_Cerebellum_volume\tmm3\tfloat\tVolume of grey matter in Right VIIIa Cerebellum (From T1 brain image) "
878  T1_GM_parcellation_L_VIIIb_Cerebellum_vol                 brc_IDP_T1_GM_parcellation    131	    " IDP_T1_GM_parcellation_L_VIIIb_Cerebellum_volume\tmm3\tfloat\tVolume of grey matter in Left VIIIb Cerebellum (From T1 brain image) "
879  T1_GM_parcellation_Vermis_VIIIb_Cerebellum_vol            brc_IDP_T1_GM_parcellation    132	    " IDP_T1_GM_parcellation_Vermis_VIIIb_Cerebellum_volume\tmm3\tfloat\tVolume of grey matter in Vermis VIIIb Cerebellum (From T1 brain image) "
880  T1_GM_parcellation_R_VIIIb_Cerebellum_vol                 brc_IDP_T1_GM_parcellation    133	    " IDP_T1_GM_parcellation_R_VIIIb_Cerebellum_volume\tmm3\tfloat\tVolume of grey matter in Right VIIIb Cerebellum (From T1 brain image) "
881  T1_GM_parcellation_L_IX_Cerebellum_vol                    brc_IDP_T1_GM_parcellation    134	    " IDP_T1_GM_parcellation_L_IX_Cerebellum_volume\tmm3\tfloat\tVolume of grey matter in Left IX Cerebellum (From T1 brain image) "
882  T1_GM_parcellation_Vermis_IX_Cerebellum_vol               brc_IDP_T1_GM_parcellation    135	    " IDP_T1_GM_parcellation_Vermis_IX_Cerebellum_volume\tmm3\tfloat\tVolume of grey matter in Vermis IX Cerebellum (From T1 brain image) "
883  T1_GM_parcellation_R_IX_Cerebellum_vol                    brc_IDP_T1_GM_parcellation    136	    " IDP_T1_GM_parcellation_R_IX_Cerebellum_volume\tmm3\tfloat\tVolume of grey matter in Right IX Cerebellum (From T1 brain image) "
884  T1_GM_parcellation_L_X_Cerebellum_vol                     brc_IDP_T1_GM_parcellation    137	    " IDP_T1_GM_parcellation_L_X_Cerebellum_volume\tmm3\tfloat\tVolume of grey matter in Left X Cerebellum (From T1 brain image) "
885  T1_GM_parcellation_Vermis_X_Cerebellum_vol                brc_IDP_T1_GM_parcellation    138	    " IDP_T1_GM_parcellation_Vermis_X_Cerebellum_volume\tmm3\tfloat\tVolume of grey matter in Vermis X Cerebellum (From T1 brain image) "
886  T1_GM_parcellation_R_X_Cerebellum_vol                     brc_IDP_T1_GM_parcellation    139	    " IDP_T1_GM_parcellation_R_X_Cerebellum_volume\tmm3\tfloat\tVolume of grey matter in Right X Cerebellum (From T1 brain image) "
887  T2_FLAIR_WMH_volume                                       brc_IDP_T2_FLAIR_WMH          1       " IDP_T2_FLAIR_WMH_volume\tmm3\tfloat\tVolume of White Matter Hyperintensities calculated with BIANCA (from T1 and T2 FLAIR brain image) "
